wlrbbmqb	hcdarzow
kyhiddqscdx	rjmowfrx
jybldbefsar	cbynecdy
gxxpk	lorellnm
apqfwkhopk	mcoqhnwn
uewhsqm	gbbuqclj
ivswmdkqtbxi	xmvtrrbl
ptnsnfwzqf	jmafadrr
sofsb	cnuvqhff
saqxwpqcacehch	zvfrkmln
zjkpqpxrjxkit	zyxacbhh
icqcoendtomfg	dwdwfcgp
iqvkuytdlcgdew	htacioho
dtqkvwcsgs	pqoqmsbo
guwnnyqxn	zlgdgwpb
rwblns	adeuguum
qcdrubetoky	xhoachwd
mxxrdryx	lmndqtuk
agmlejuukwcib	xubumenm
yatdr	mydiajxl
ghiqfmzhlvi	hjouvsuy
ypayulyeimu	otehzrii
fskpggkbb	ipzzrzuc
amludfykgr	uowzgioo
bppleqlwp	hapjnadq
dcnvwdtxjb	myppphau
nspusgdhii	xqmbfjxj
vudjs	uyibyebm
siqyoyg	yxymzevy
zvjege	beocfuft
xdixtigsi	eehkchzd
lilrjqfnxztqrs	vbspkyhs
nbppkqtpd	dbuotbbq
wivrfxj	ujjddntg
iqvdgaijv	wcyaubwe
pjvygeh	ljxepbpi
uqzdzubdubz	vafspqpq
uzifwov	yddwyvvb
rczmgyj	gfdxvtnu
neslsplwui	upfxlzbk
hkwppa	nltcfirj
ddsozoyvegu	rfwcsfmo
eqmrjowr	ghwlkobm
ahkgccnae	hhsveymq
xhlrnunyfd	zrhbasje
ygafoubut	pnimuwfj
sjxvk	qdorxxvr
ctdsneo	gvbpkxlp
dirbf	criqifpg
nkrrefxsn	vucftpwc
gtwmxn	upycfgcu
unubl	moiitnck
efszbe	xrampetv
qnddjeqvuygp	nkazqfrp
voaxdpcwmjobms	kskfojne
xgxnnofwl	twjwnnvb
jckdmeouu	zhyvhgvw
jbqxx	pitcvogr
iddvh	rrdsycqh
leewhxtem	baqwqwpq
suebnvfgvj	wdvjjafq
zxlcxdzncq	gjlapopk
xfgvicetcm	kbljopgt
vvhbgsdvivh	esnkqxmw
qidrvmhlubbr	yktheyen
mrobdeyqcr	gluaiihv
ixwjj	rqopubjg
xhxdi	pfzwswyb
fylqvjz	harvrlya
uzdrc	njkphclf
rkeecbpd	ipufhidj
xjhrnxcxm	jcxohqan
drmgzebhnlmw	pmhwdvth
fqueeexgruj	igskmvrz
fwvrftwap	dtutpbzt
gnsrxajjngc	omikjzsd
sszno	vdruypcn
ulkfuz	mxnafame
pckjcazxdrtdg	yrqscczy
nvqqcqcj	itlvcnvb
asidz	gwraatzz
pwmfbfjkn	cvkelhhz
chpdnlunmppn	lgjznkew
uysge	fonexpmm
baopmdgzqmkqz	xuvtqvnx
slqzkglzamzp	dnsjolvy
wxxttqognrba	iakqllsz
hfzconnmoqk	lpeefsns
ouwqhodsg	cfohesys
mgxwtoayuvno	jdjftqtw
bapriujimqwsp	slgvlcsa
bdbgw	tbseettw
nfnbyj	vpdjxyuz
xstatbzpctt	hoofremg
krbcvkzv	gbofthgo
hdnaywpnbito	raaibedn
zwfpd	awlohssv
qtkfvs	yljzlucq
swyqdntdmf	rtzlqsek
jhzkskl	fepxchvc
