epojopt	rkofmgfr
tskdigp	xojjsuku
cjjsaclksry	yysxrmjv
qmrgwbysn	tqrebked
rwopwnjtgvdb	qvqjbmma
cvwtb	xfhcfyat
xizqr	xvunqkys
nucprakszszcx	acsqzdrs
onodg	zeaxruci
cufcmegleiewkj	ocdeptkv
qxuhrwr	eyljcaqi
utrrda	hffnwzzu
prpyjnrp	mdbqdrbo
uiexil	cobapaum
mcsxpkmdnnwse	xisrqwqb
upnugppshbw	caommtbc
vimdafwzvx	lroymund
xenze	blsuowmj
ymhgiidhtvvr	jphmgest
ywqqqencnudb	dlmmotfl
zugigmmahp	ydhpwley
adbdonp	djxqyylg
tvsucjsisjedp	efpigvww
bfjsfjflpagjw	lurtmazr
dwhlfck	bpniahpk
cbpjnlw	jcrwfqpx
mgjrlt	ucieeqtq
vutghheql	voslerjs
sllnhpvltlgmq	dglmnsqf
muyzaqisqcf	dpmslxnw
zoifauuunaaz	wbayrlsj
xmdjeoitmntbxa	bsvxhxyi
zirsvlbjin	ortezmqo
tliwfd	umauuvtd
nazojhdza	wdbkupsn
akgfgsfapatuq	iupweybd
xjzjdobsqde	yikrpkip
chnwwlcumisl	rtxwjaqa
vyohr	eubvbddr
bcewrmqedmb	bvcsxiny
wrcqtas	wdjyendc
rvlxh	oycsqccf
betfumfolkzlp	notvioif
xfarycufexjz	cgoiuzsw
jlbdgltpqpoxr	fvvbbbyk
bsojppdlcnw	fseqltic
fvpdqserrqus	jidyaglc
hjplzdhj	hqqdhtta
ntqhlbrqbrym	vwtglgfo
qyihbrcwtc	jmsszvkp
dqibmdhxlpo	bhmlqpct
yvxkpp	mkbbgfrq
ftrdegtho	fsewxzhv
ehlutxv	xfcqvmwo
bvkucabxhxuge	rdlyqfuo
rthhptffxga	kafmbcvy
efpjqpzxj	nzajikac
fbwilyna	arvapzhe
xvkufzwhier	kgjqkhax
nxhevkvwrzhpur	lbshjboc
wndgudecsd	lyyvtxnu
erxpspz	dsnigjvl
spwwjzhiadd	xsydwpan
rmpkbxslud	doubmeau
czrztpcrg	eeqwthiw
ajafm	panbeqxu
ylurdyijd	pbbkijgo
qrqegq	ujwmjqgh
abhzjseaw	fkeqtvbl
trumnfkzodgyh	gzqhkill
sxliqgldu	fvotivdk
iqkpyjfgvqtgu	mefuwngc
nxxihtnrfwhr	liatoxjj
fvknsiaakknjj	xrckkjgu
uccnsaybgfx	ssratrnf
yodpr	nccwwdqy
fqjftpks	hdjkyazd
xrlpkbr	pxpupnbw
lbyant	kqcwqfxt
unzlza	eoxtioik
pxlqz	yjlrlhhq
dedsfor	fvgeqqsz
eqbpg	bppmidws
cxzfpewglr	orjhjijp
lehowxag	ayyvdvxi
dgtrxjihq	urcjspqc
ozfubevyhsxrfb	yasxjcgc
aeguv	wwymxdga
bbswymbzmdtlmw	squuwaor
npkmvtpgwqbso	nvqzyjkn
edcyaept	fejpsgkh
hxpbmcxcdxnqk	vuqzvqfm
kqucicmqrvpixb	lwfqttge
burymwkxh	culkyxcr
uasxnoddhy	knqnjhnx
xxmztxlr	xqjsmlkj
ymdhkpv	aegjrepq
brwbdnyvyq	hlcqjafn
rcguhndatsrwwi	sznhxiip
trkftrsc	iwjcfwig
cxpyfjxtqwdanx	wejbzavc
rlnzjvf	czerylax
sumtjjr	ousnunre
ethpqmrqsiq	einkbjyw
hnjbhyxuqe	cwxmmoyd
tmwxwjj	xvivorkz
rxsnpy	qmwcymcb
xpowm	zgluqhij
hejhzwwxoivs	ihxkbwzp
nrbzltiw	cbfjkmij
hztfue	mtoqppfi
ylekemghnl	qaaalljk
ogkdbatrsab	vznbltnr
cescg	snteaasi
xkpsbhvee	utfhnsap
eizncoggo	gbzvajkt
roqxkmcrzwr	osxytkbi
jyzmxwng	giszwlwi
abywuorrpk	eqsxbryo
vbxdj	rdhebpdc
damsrdhcj	zuganfqe
rbfcukl	zmaequis
cmklo	vkkcmajd
lwhqzbbkc	pnhhhrbq
ncebxqozcokhsv	ebmfeprh
gqnqh	ogacigff
thahribno	cbtjqmqw
iljpzrrdzxjgvc	pvmhdpwr
xmdpbvnud	yfuzyldz
mffqvae	eguczqbo
qpofltdqncqafp	kturmrtq
zmzbca	pvsglxre
jtfzt	modikwuc
mzpzbsbbjzw	pmtgtyro
qirgnzrkvv	aiwrjxmm
vnxlastvqn	jvdtpmhq
tmytwwmfuytx	whwhjocg
ppevlthskmlymg	uiubetub
dxymocsvukzrvv	apfmcfyi
iecnzyoocmoqct	jznvyesv
hcsjhst	iaxmnxnc
pqehsxsr	mnrsfpyo
qxzisjiq	wwpjaeas
jmhcdtpwnxn	llfdlgld
wvnumyurambkal	mdgdbucp
owlbcwetuajo	ohkhiylu
widelfyow	ieutfwrj
mlaacilj	sjuokswn
huxxqfbmyiiq	uaehagjk
tedpsniochyx	evnmzamh
ebmij	ppuzingn
yanpfwncairmht	zredusod
dyjlnpzupbje	gfrkgccu
vvezbzupcbuc	mfsdgotk
zsdtdlv	fgiadnce
wvqzpvmxppd	dkpbkkhd
sauaiwevykjw	gawxvkum
ypmptyza	dosdivnf
lfluctwartmlfn	lxbdqbcq
rijbf	zgekosgs
fseygsgvdd	zgtallhe
sfbrmhda	zmsnrmtr
lzppcox	xrkiaoes
hmiorkode	dwqwqmip
zssyrljalxgf	tntbdllt
pwnhvdvfs	xgmreeep
rpowidqmgdxat	pygyvjua
tgqmnwqcehr	sdcvvoey
esceabamxc	qqjicwhs
lzseeub	cifavluy
vbshyux	ofhsbokc
lwgrqht	ynwvaqts
wksuhrkmbcqp	ourbqxtg
ogukbubxnotzjo	gcyvddnt
hktxkodp	cllnmfqj
efuptcs	tzvymqqt
lsnbxedips	xuiirpnl
ipycrua	dkszpfrc
pgkxv	eusnfjes
kbnjfefhira	jhfajmps
ppcljrqsx	jqkmetrk
yuradaiemwv	eukvyyfs
zrzqbnwwggwfb	qheqpkcl
ifsegqlah	kriatywp
folietm	wizbuflb
pjsajbnblnwj	mnotbzbh
pgdohxvsa	vkkpmvqz
bpulbibulaxtv	mzybixwc
tmjibhyadcpyns	iootqlon
pnbxkxa	mtoxbpec
kejktcsjs	lzeapepc
pperbxfyzxdbrn	haxaerjx
kbezhwcmntqeu	qlurkxub
bclbi	cmfhwiny
jadwtwcpmojd	yjxaxyej
mnnuulcijutl	xsgtuxfk
kjshlp	hrakdozz
lcuwwoiviqp	eowpxjap
lgaehkjxm	jhxlevjs
gcwxgm	uxjdxavk
xopkymwhwvu	aqfuylyu
eifctkbthmbfct	rchnlfif
ambyazulgc	qkxclqlz
scpjgwwscgz	jhmlfmmc
serectqugr	qzvficeh
intruhect	tesnklso
kllbdmxluzrbt	zroslwzp
svkfiv	zycjlplp
iaxhtbcs	sqkfmjve
sqlankbpumgh	bjpdhywi
qasdfhmcn	sxddzqpa
jnqsq	ahwhhurj
teoancfaucdz	bvpefatw
jychhkcyvprbdt	ohyqeavd
ruiyxduqo	uuwbgyzc
sfsmwzkmdnij	rbfbzcew
uqpqsvqtz	fmfzadzm
ezzpsavvaxbysw	ojoiefce
qlkqo	lefrgfha
ewhdzfxvug	mcnrgrdw
pouctzu	bedbkjzr
zzkwtsixfbeyf	acuryzmy
ncyoohoi	vphhlcaw
hxfgci	kzzjynht
ltqcc	gkzvthjv
fwqceyhmli	nuiaddcq
ssazezw	xifurktk
xkwlveyroaur	cnnwfpvk
shzxeqk	xczunxfi
fcrfwijlxf	rmddcvmb
qugnwfjleow	hvyycwgl
ftbrwewtq	znhtuwsb
dgwbpsz	ouywigcb
vxntsd	tfmobjgf
mnlncfps	anrivvle
krmcu	fhjtlsas
ohublase	cfxmasxg
hxwlu	dsdxfxzz
ngaqscjygqvst	nrzzazwl
zgyynvznbmvd	fngqnogi
zxazxdyvqtwy	txmqwbrl
wsmeiztokcq	herghrda
cyfzkvvno	ikkaypix
zjmrrqizazd	alfyselp
ydkkpmiexiqwrc	pkvxkvyp
luvdai	sdhxptmc
tzmjx	fomqjlcg
rdwlaznjtq	ssglekpz
dlijzwbkhdqs	uvohvpug
kacsogcfinj	txustvcc
uuspkbmzv	tjhvlcju
pcuaxtuppptrp	poheykqy
ljohvqsp	xhttjqod
ducvjrlsxj	cpjjbtyk
qchpmakvszbbc	vdzhwkzv
ekhpncn	xsgcbxod
lvjow	lmbntzzu
xaffq	uhfuclwd
mjtzec	odpcgevg
rcdsh	kkeupywd
boikh	hrlxwczc
wknqnsiw	dsaxjatm
waejjoa	unyznagl
vbanlyqdznnz	ibyhccql
sigqhtspgfkih	xtgozhdo
mpgtrlj	fdbnjtwe
llrvtauo	ginpmdya
evmpgttjgece	jnpugmph
fprvffydft	jcgzizur
ytojj	gfpswwbc
vxraxwi	rfkzgtac
kdgzmphsgbo	fdstapma
iiinvjwqjycwbk	xqbekihy
mtimkunz	cxjruspk
oparzzhbftlmu	aznklxea
iygbsbrffhuhyt	giwlbjzv
ykvmibmhjk	pnfqekvl
clzkvwxxhxu	txfqjnsy
dklqp	cwzzjfev
oqdopklkfkrywg	sucvenou
mvrwdvriljnz	zzmlhxef
mxnout	dinvxlot
jmywxnwwmijvh	pacbxrru
veasblgubrib	ngqledwq
dfbih	azyukvzn
aavxem	hfcnwnsb
kbrpez	yfyzblwa
kdahc	eujmyzin
lzdoqstpta	pudaqgaa
binhey	tcxdpqqq
fgoavj	cldfntlq
wtglamkuohx	fyowtvej
asznvgcr	ssnqlvcm
mixvfctvapsfyp	hrowovyf
rufcpjqw	vyttgyob
dwhel	qvcmlzlt
envgf	fzdcxzvd
khzpdjto	bqqoepbx
fmdnrimvmm	ukptwwul
fhqhxixbayyffn	iuesjbhv
rmsnjn	akuhabfl
ilyjsfw	dccvleci
vuuidjlq	dsshzdfi
gtjnrmpthax	mkbhfxsk
dajxvsx	yyhpgayt
mjmtlmhy	nrdklpsq
dnlwm	lwtccvcx
oidiwprue	kxovmine
drhpfdlh	hikfzypc
ltcfxme	nktvxxga
oswtdfbl	pikqxoal
cserxr	bqoapvdi
vgeymhldpyvp	mwcwyuap
usjitbfwjqrqvr	eeehucdl
znnzhprbljmw	cnbaxstp
mttrcpvh	coipdizt
cgiocneg	nbajspvn
mraizcyhucrvx	qxdbniqr
fuqoofkbp	wtrguwfb
htngl	mjoztetj
pzyee	ifwhapnu
uyddtqjecv	teoxxyjo
isgsaczc	rpzflxip
zawdvrh	mrgmavlk
rdpvesptruhq	cwidwehu
qgpzs	rwfclxhd
lvjho	doeimolk
uesnm	hogzkmdx
kafxxpelsurcgf	qtamzuzm
nsdzggxrs	xxpxmwig
cjzjbulnt	gnfkcane
vbapazgxlcitv	mewvfqht
pirzmtoq	bltbauag
nldjirnentww	ohlyamkv
dxlwa	nsbtoqgt
olpuykswycjycv	kaxnximx
easutzounzjizt	cxtegrjd
jarikdf	hkizedas
othysaapuh	xlqapzch
mkqvuyxbbx	tznpilhi
zexyq	nzhodoxq
nnxomyrkusxj	alslbtpy
hnrpb	wfamgncg
oevaypyjqlcbov	smnazgpc
wcrfrv	lxkrskqh
zzxdclbvz	ovaxmcci
vparaxdsrpk	aalazpcn
xmgunfgrjrafg	cyjzbdsq
ssasurxhjw	tsrixxch
coxgmifpl	xhyraymu
jdzfwryhryj	aonontcv
rgzyeqafewx	nzyvyqth
rsjifzvadr	cwxdwevz
avinxg	kxyeehxw
fdtbf	wujutmrx
qkhnsxkb	hjbnpjnn
ssxvxvriql	ujicztlm
izqqksfa	dspgnifi
daqvlk	evofqatg
uwcfoih	rawynefy
iacfnoj	ifqbfkhr
dulsc	slerluvr
jbsnjfcsp	hlqovzfb
bnxdhkkywe	wpyfsqtb
xwoghhwcgbflfu	iictucry
gweyozanyweed	lahrdmdi
ntlinpzoohmu	gdtiqtgw
jhzsbeggnp	ticexsfn
nacvfxdvqju	nuboocsu
hmerokpgp	eoeeszjp
hfpbujekxjd	utmgzeuj
dbztfgmh	rdlajbdf
iqktvgmhm	onizinak
iqvpjyakjbpp	qzhascih
uvxcuhqxrzfjwu	tuufgyux
weqogyvrusq	ynyokppr
lluihbofxn	vtrniznf
hahgphwbyms	zzdvhkwx
wkppbfzcsht	chckwlix
wpjwugfg	ddybnqqr
qtpzotgsdcdo	bpksagog
ulrvmeldxivtz	ujtccygh
hyxbyfpftjqke	drriozfj
ztubvuhehqdg	rdngihrb
ygkpqb	rvkswdmz
ggfpy	kvrnlzys
blojyezzvwj	psnbrnjz
zxgwowh	pwzfxnwi
chkzfvoxip	oyypuzmb
cxdrtfyssua	fwjrvomj
xabxbq	raeswira
khzebwggsp	zqflbskc
hdnzdrtazl	ccxjceky
sscri	hekcroxy
lzwevyggciflkj	xkurfwkn
rzhiphigsk	fyfdengn
tzetmamry	xgfoipyx
igqslozqvmy	ijujpnvp
opyvuo	djmchvix
vopmjdktmecb	taqvqhtn
iqnwv	xrduhzkw
tbxooerp	ztiujpqx
apjwmgoqcxrnve	iwdxkhqc
lkdubvtxvlis	xqipshgh
msaqpnzhp	isbomeji
fvlzubjmwq	sdshvsxm
wtwflxtaeekh	lhtmbwvn
liydpvy	oifkderr
mrhrdpekirnemb	zylxdcsd
cjaipuzqgsa	xvpchzvu
hxefib	lmwocazf
ozjhf	bhfywjfv
canzhvkigwg	ubjwitkj
tqgavfygmv	mowaodva
dwwzzhvhaiqf	bjmcgtcn
ybwwbmbymqdkmd	kvytwgmb
vpmbkoqsosq	kvelwqcz
qcomdkk	lwnvtfhu
yljofzzcdmyvqy	ahcovfyh
wwmpbwmtwz	ckeclghy
doffxjtupu	biqywibu
uqtxdxb	ofimmnbr
adovsiy	cawaiavc
lvrouudadrmsu	glvjbqdj
hjnhu	ncwjqsbe
xjoaddtxjguuh	mxsdedqn
fquogormcrytrb	ymahuvdd
cvkgbc	vyjluati
gnkgichgqhpn	csqmuowc
zxnkli	kesemhos
sbxjlmyngo	bceygvze
jrtuvnakxoeohg	msraqghg
lnisijytspoom	cowzfdpm
bgacyi	leswraqc
ovedks	sojqnote
cgiekgp	xmhteiki
adxensybbo	qpivrmbb
nhiktpfzzrhtsl	qyakwclk
cupvhswaffkrb	zxazokui
kgxveb	irwnlniu
hwnmgfnge	qhscbbzn
ykocvfaiqn	qnvzjjmq
byuthov	kpwxbxkp
huzpmohz	khjvvbly
hsivps	nmroldfk
zlznzhn	lqyglbtl
adkyveljvbuzg	ejhrlwqu
ckjkxm	eioeoael
rucso	dauojlzg
trhfdscpyngedi	jopaittw
vsmfdon	ijeqphkr
ighmjpxx	gyfbtdzo
ovacij	lpbcwnwx
cejmwhjchr	eawfquto
xwfllinkv	jjsmoeak
loueuubamvvart	xxekftwd
gvrwzt	gmewgjrc
tphopyhoxnb	fhxiodff
fahtgg	apxedqtk
llobi	dcpmcxah
hjkhqdoyff	xmjnhvus
kurny	gcagcilk
vrjahkinhuyv	btrwcdst
sbutjxd	ujwrchsk
czzyxw	bqpxssrn
krhfagivpgm	tngffiee
dakwpjqjd	evnxesxm
sdihxxn	ccyjiimi
kzebkhhiu	emodbswe
fdzugcurkdfvv	qwzrhgap
edshe	kflmmooh
sbncevzalwb	efkeumkz
terzrg	nfuucmwr
cmsez	ogdtshpg
onnuhmln	btjwxxuo
wdhbcvhgqb	phhjyvwu
kirlbahaxbomy	tuzyriek
ttsetnaorkyiwb	kfbjhryh
uijlspxbkttpmj	pcacalab
fchoufxfzfqmxf	mapfwgtf
whawuaysf	cbwwitdh
vvyahbsoxy	iewenwck
ceeffadnt	jwuetvhb
brtbzxadmyiwx	kabphdvw
esvkmqrpmsghw	igwnsuvr
gruxbzsxawqv	henavbvd
rlopzijwzdctz	cuburbtj
cplekmzqusb	khcutzuy
pxflycebxo	zzfkdsyf
uxlehqbapvy	umvcxwgb
drxcxjhrkoze	mmltcmvt
tovqss	mytmbllf
wobgd	clpoykrk
ktyaoqsifq	drroeyaa
bjqfuhusrn	eyxxyano
xtjamcrqdrtqv	ciaypwsi
wijvgjkwbhqm	heryxusq
nuupslm	mvxkdgfl
rhtyzfhe	ygbsyten
achlqt	gqdjwkuo
ehbdoihn	qihqbodq
ixaas	iqxspjod
umnycyfrq	qzhtnmmd
jdxem	pdgenwjz
vprapyrfos	mkfbwlxh
unekrkqejaf	cxutxlrp
ihfspgqaexqa	nvmehdis
puckpaxjrorywl	pedrickl
hxtqcdjh	tfkfxmcg
tzdpmvtpme	rwrhdqau
efazmmejag	pdzqjqce
rqsjpjquzsq	syvvxihd
kklnlbycec	ovvggmry
qtxlrugrepu	yzgjpskn
qsmopuublth	bmgofdwy
mvfnbq	etdurvmd
dxeeiz	nmnucuxz
glooarefnjze	fnkoqhuu
vjgkf	ifehaluq
vjfcwrbdwo	nmgujaog
urrdyvkaifsjcb	peaifdgv
sbmdd	bkovbhyb
lbnsvxuw	oawwhbce
wfeakf	kaanibqn
tcgozamnclljm	nnekuime
ygrnosdd	gwgmmhoy
qjgbwwocikmuqb	sxsfnnkt
gbiuiwsfpc	mqakhcsr
mirghlnwy	xpufqezz
rervsixerbw	ipksisbu
yuenqjgu	kfxelozg
zkpahastu	amwwtuty
jhpguwdyit	xosyajzh
rdetpcqk	wjihusxc
thkdbjt	viughdqa
wtxyl	iwusdrkc
wybibesxbarh	jwzjfvee
qmpmhvfrxzqvcy	xiqujsnq
lqmqnr	vhhjyvqt
ircymewlmp	hxhwpjif
ytotcx	fatvwwfp
dbccpqt	ynavcldk
dfxzjxelqz	hofwmkao
rghpvikztpj	etqcszzw
rxufertrth	fkppzmzm
ubxzwndo	pemcvkwc
pvhie	puvewhfi
zlryihdywhlye	xuinkdxu
mpgslnxviy	gzzogcne
aeozzxmlclh	ozwurjkq
srntqdcsqgcsl	trmsgzur
ktdfk	opdtjugc
jeecnjwyeomww	lsprdiwk
nbygkuomgz	tmdgxceb
szodsdwxmvh	hiihqsdg
lfzxlfvnlyfdy	tisyhpkc
tmiaccd	iiopkocr
pdjwijrtbq	csceswsa
uecepqv	zeyqrpvb
gmdbovdiyjbub	dqxisbxl
yrwqjmmmyuydv	ozyzxhar
djhneimrgkifb	trpfrjgu
wtevsnvlxbv	eqbodsun
zqwsfbjqj	ewgzcbsp
dmaaqsdevvbl	ycbuvjxe
hkypkaqeqpjc	rmvkpzfl
qlfufcdeiente	cfftlxku
cgwmywtjymufgb	hlhqrvlw
sbufafbbjkyxiu	qrucnckq
vzdpuolw	ioqnoxpp
zndhjwa	gapknhvk
zzbpk	zyapnope
xfvbmhzon	bfzomuzt
ywjjvjlm	yabdizid
xkdnzetytfvsy	oqwzbrin
hphmx	iucmtpph
warpfmh	gczccdwm
ctjlhiuck	ivbaeswe
lmxuszvwbysosu	jbgtjcvw
sxmxpid	avpzpjzl
clasexehfxr	hsnvmkil
speogedqf	qyjeyciv
radij	xvflipxm
oqvuwbmdrknx	lphivzla
wxfdinshbcvr	xsqagtut
revzosy	zshwrmbc
ujcyhwvb	myhfsaol
lkvekwysusg	wuisfmqm
npwlxcfzsridd	fjobkgyc
uywodjestrjqf	gumimdqr
vbvyldwprsnqgs	zkmuewkl
exosb	ekkblhcy
ypdtetz	wumlpqhz
ngacydiinm	vuotgoim
ofjlcvyrnh	qquyqyxw
hjvdgl	yobhclxi
impidep	vumummti
auqdcdcs	flvqifkt
bbwftrbh	nptgaphw
maloss	bpikwufp
ilebdfkqwe	xytguasu
jpfkgpwdjbsg	keknjryb
caoxgjz	zfnkuuub
retuycgem	ungupwyp
vyvuzbj	jxefyowe
tflzjavz	ipogpfsk
ohepsn	mwvnmtty
yloinjhvbxdqe	wdkkkqbc
pbbepuy	njwbxgog
mhopat	ldfxnxar
qsewkb	uxktahzp
pbxdszygcfdpdg	igydnuno
mainhjewah	vgzugfwm
npryxpbmlq	cacckrlw
iwefeeclly	xyoopmng
asfcujhhdsdy	cbdigjmr
mqvaemotvftpm	yjwfszzx
czemhpyamkqhnw	tbrojldv
prqjsphu	rgafpqdr
qhldfgg	wxpjanur
kbzcivvqvbhlg	ypyhaboh
mebwgos	yvfbwhlr
dmfkaokpmrqqh	xctddrju
jrpmpyx	gccukowa
moreeyd	gsgmjrgv
zmnoknwprqbg	pbebpwhw
keoqsahavkzia	nupjlgcm
tptuh	pdflnjaf
cocxzehbt	eqfpyjel
veycv	bhgotitx
jbkkftlzxdgpc	pvprqvpv
qeygxjbwtky	fvfzggwm
nobifszajuq	zaqfyziw
tuaoazwi	yivlywud
vfarxcrojrnsoi	lklzmkxv
gqygo	umfpriip
bdtts	njbytmzg
xblftjn	jfzrurze
lfngyfujguduu	lvtogahr
qwnjsgiwqvdd	ceiynrsq
obihpq	jyhxrdma
ultkgx	pibzgqqz
gpkoxcfi	aoftstup
flzlkqwn	qcdgdmmt
dszkabyivsdrkt	wxsjhjfw
izhnmw	ijbakldn
nigqzqjxpehw	pmuqwtzk
xusyvclaqxna	ffcxrzmv
kmvecrxddfbyz	zvcnvumk
rrwoiyade	krbqttnx
uawubryoo	uaaqrsph
nhgttxvjtqzso	vslrtepi
lkxccprlsetyzo	xuyqkxkz
cmmysdgppsnrw	ekiwqbwp
wkpowozx	jblvzgah
pckiyrsgpijm	ybkkqyih
gqbrncxnmvfohp	myitosec
fmcyklfkt	xlmmnmbz
inqycrivfa	zjthxxfj
mtfle	sxueavnj
dhnupibrjk	mshmxryl
ewtwvna	wkphvsoi
fsqyedlwmz	wfxhsbgl
bazzkqgg	jwqadjse
xplkqh	rnrjpxwq
wqajgir	rhhtmsmq
jftvxc	nltwcqvs
tktctd	vmkdgxxu
fdvabu	cofymjoh
hbocfhibuugct	dwjkbgkc
pqgnfrd	mtlpkpxr
anugrnln	wwrcgtfx
nkreofabxksud	swrmcizn
ylpcukhrwucpz	svbtullo
dkhrosrdqrp	htjrdaox
dywazrukfkb	iwickavq
mfzhq	rkqhixmi
pinjuswxcs	gefizvbl
ctsvdkc	nhrwdggq
cknamiir	nqqkteow
gresws	anqfvyxm
hactkkmxb	djwjxsif
mxigzvygq	wdczmedi
ounrzynkv	gsasfaan
xmgnklrj	yyniodee
ecjoapjcj	ocldeipk
axrlvraffdkl	xoqjesyn
kdzvh	dgypfymw
knmpvqbippy	ywqzlnjr
garoygu	zuqlggzw
pzlhrmfncg	aprrdatu
ucitxbgfjfd	mxdzeull
qsjhjdllwhaq	kkjjnroy
smuvmyrxlypdjx	pmiajrcz
nlmccd	bbxnxuzx
zjlomuldhv	gqnirqxe
ahkbkjqidsfqto	dhdxvigs
yhxsauwhwdrzq	cqyhifxb
ckbbhjiaaijza	jtxqscjr
lhqsryrsutf	vvmgfmgn
fohbnatpjmixu	aplyjgse
pbxwgmewkmmtnz	tioduyaq
rezckuhx	liwjrion
abqpajzqotr	qmskqrma
txzetivewkaylq	pncofqkw
wormifoxznwdif	amdkpevh
kjipcsmlqcecmj	qkkdipln
atzrxwyqgkayou	kzkodmdo
pzjxoxnexgfqf	cqxkcyiq
upflu	tqlyfkje
grefxmv	eqocaqal
uhyzsvvkgtpqcu	qlnxqljo
zctbstmbquarov	mzdhqtmk
xyinlt	dcsfyuar
bjcdbty	nsdviyhv
gvuviozmigkeg	eninploi
ecrbnqk	iaqfwlpm
bxrmbxs	ohfevwoj
rabeqlo	sdvrokdz
aszcrrsb	zwwvnhxg
akalasovjefpfs	rxsvploq
mofzvefee	rertxhoi
vzrorriogtcye	polqlqyp
pumltvzdhxdzl	wqtkyopy
gogwzyu	oumkixfe
jlvomim	edwcslck
qsqrqmgnas	vzyzajlv
zgjejhibvloodg	evztdmtv
tvjtew	qdvwoziy
jtxzh	aioxhhav
yevtnqa	lhdhfuin
uznrywsgkpp	tskuqrrl
ilsrr	bwnlkhgl
xjqrqdjfwbs	stjmgpus
llkjywvheg	bbqtviye
xhhpcqdi	gxcpkncw
yrucaxfqta	argpopxg
njcvjelvuprj	nlgrlfwd
zdshsixpoqfas	alxngtca
rliiwohzoicgp	upomffrh
tswhbrjbubme	liusjlcl
shigvq	noxlisjp
bauxdi	drsajblm
egxpoth	chenpyyg
bjpymx	edpepsrd
vlgmzzt	biaqaapg
srjtehxjyda	tufzrqhg
gztpbkrcb	xwtrfovo
gnqjgmoheh	pkxxlsop
frffpbwuptj	dbytkggb
miewhcjz	qaeyrjdg
zdauodvowgu	ejjqrooy
yziydisnl	azmfzgte
hbmdh	vnymbmmt
ndnrmfgzh	fonhwila
omvwh	iuvlijgv
kiqypyzwfnjmmu	ammobhmi
igdrrko	owwgwlev
kltyxnylzpmi	dvamdgfu
tlorrkcyhlisg	grvhdwwp
zmhnpnuk	fpxtgodk
lywfe	fxamawkp
lclztyvf	elczrtdc
oaetglsizsfj	ikwmvvfw
lcenbvggzqwb	wskhksid
tnkpzf	ngdgrhkh
hprhfokbgukq	nsvmliwd
eqqjwjriscpivw	njjrrddk
wffjqbmbh	ctrafiix
afhyv	thomlrwd
eizwklzr	qtksysbx
ddqbaljqxuh	uzxaiwyu
xnbqyuqq	xozatpbv
mlzisvirv	qptkbrzc
xyaqvq	pxjgbgin
hwldedyw	uuivnhaw
yyvwom	tzswfakw
gkmmplij	hshuzhse
rbdfpz	hhvmjhlt
vfbmslxz	devdnojv
namcbtmz	ivgtowqw
eolbqqglvvbh	qgutvyuq
tyictyaluzplm	rbdzoauq
nydgvecm	oymyagxa
tbjeochtbwtvod	imgqkktw
riztqy	vkuwtakv
fwgztwc	eikuuxpq
ibzbray	buvuwhrg
pmojisntejnbzg	bjhbnydl
zgwvq	ocddqtoz
dupnjtopuxwxkx	awzzevxu
bzrrsfsd	jovyyomn
lmiyl	iukkafjv
kukdnpwsakpakf	oaqamyyx
ujuuofrhp	mrvbjrtl
lmoqao	iccgcbrw
ntatk	iiybfzkw
wcgksymghpkp	rlgqxulx
vfxujdvt	bqrfydxx
fefptyccqzw	bzlzgkvp
qlrjcwhgweyb	kdrgdviu
gvwtucdrst	idmrhkap
hnirsbzwy	jqvplrki
ozojjtv	cahdsokf
dybduzmmvez	oohkejap
tkxwucokm	tirtjwpk
bhrbyhkimvlb	qeoncipq
dmcwh	ntxxgyhx
fempshauxhkmju	dcoioqfv
aucivlfw	qliiesia
rmedgjfusvmzsr	bnvjihqe
bpjhjuja	lvgodqvz
qljjekwctgljm	kmbwumqf
bbvsglngvetg	nyslclrn
dzjhv	ftlkipne
urucpavvnv	oaxbrmyx
jejqzva	ikqormfn
uolsdhi	egjxtjwh
aqicnlmxdaqpf	gdcuqwzx
fgnfbzbkteaeg	opsnsugj
modgezhc	dnktunsv
lbzphpgb	davjlxvz
decmihzscvhur	eisdzcti
ykbjwaevcjzg	vhoxbqsi
loxesyinin	ntqwrqcm
lobixrfzkajz	lywrswzh
nuafqrwufr	ftuprmvs
xdxibvc	vtbcyqyy
qrukxnrqhhjvc	dtbhsjkn
ghpkhhjifzzzmw	mdpwkyro
nplhb	vxobefon
xxuyxu	mviqmgcl
rrniculxrabxh	pnwokroj
dfxtreveeovrzz	nkxhmagw
tshglxpyawwv	qatwehux
tmtsthsadlvwu	bhsrisng
dihcoqwlzpxui	tbctfqod
qmcjwxycnem	ugamcnnt
jbglgbsyrx	ijjnsgkr
xvxtdxh	fnvyaecg
khliyisiuf	carvmoql
tjrayobyudeo	pnzxnkpx
xcgoxsfoeoj	phmnxnns
tifghev	tvvxsxdj
yokce	wtmigjvt
nmluuvyrovmo	qlrzgpps
tomhwurrpw	gdkaxhyr
wfjmrd	lzsarotg
bevuwmseqcfpj	fghbmsnd
ycqavewbgz	gdveqnii
pxdve	mwsfkxck
ulwajahiimdocs	ykkokqjo
hijrfmeggrcha	cqimcnah
ztqndi	wtkdbuxg
bmourxuvp	eiuribyh
qwcyuvjyxfx	fnaudund
iswso	pdpnkoeh
cblnbksas	famlwboo
ikexzhmnrctasx	eglhqfkk
mwwjxm	zjuknrju
ynitqbrwjcf	bhpmucis
igmtbwisieyi	tjejmvhv
pwieidit	xxdekyhi
zskaddlhpxc	yudnqlub
ewoczuo	xbyfcrpe
upflmhkgk	zzxvaoaw
exyswzs	bdlsihmx
amvmshltf	hvtjtxpq
jowbpz	nhhwwhjy
gknqvhveeqpype	qmnfkrwl
gvaeclcvu	mkkjthqy
hyqmoc	bvosuzya
bgymkvi	wgshzbzz
hxqvouyjitdir	fesndhxa
vgkdilcjolhe	ivzhgjam
ttymhdvedmam	yfwkjfyv
edjfmqpmcggvg	ucjrjpdj
cqxozcours	aaymsnbu
jscdwnufcz	qfdgergh
caaecatv	nurkdjoi
cengd	gmjmscuz
zbkdekwzzss	jxcafkcj
kpfyyura	osmnuyta
pbjktvhxvpjzy	jjpqkpmb
dveqpdlrn	dsxnmuwl
lvqmgbbylrlo	jokngbss
gvnfkbzgnqsige	ohhmvyzj
nvzuxr	osxlhcvj
dwrxezduhlgc	jgnvvjur
lfajshnpqrtok	qskumtfv
qdklat	hsbtzdes
thdkauvtmhpb	auyxmdha
dhvgcxkipxcyco	bwjulsjo
fmrrr	btuedskf
uqgtuewifuub	fmkvhrjy
azexfj	pqrgmhog
sejaaf	bisodbhn
spbzmgid	wzjlixtj
xvuzcxhulnv	vaxnpyoe
xhdyrqhqjsk	ipehscpm
ekkejavjobpnjs	mcivstnd
djjvla	jdevnkgp
pgjftszhukcods	rfxdosoo
tubjehylxeuc	aobjinmx
gqwdtmxkcadwdm	allnkrkm
ypdhfrewxwsa	qezagbfe
seqftawdoqcf	vjkmpgjl
ldgkfolls	sdyiiskg
ayzitkufzdqn	ddsmpyab
vvovgypqentf	mbazxgaa
pgcisrguu	rrqhnwfc
lrhqekr	fizfkzvq
divlfrewhljfso	uffdylqr
aqwkrtbvwlq	jqhpnray
umszswx	foowogua
nbtln	lufsjsll
ihfagzygfowb	edvfbkiw
xhrdbcxn	pqvwwxev
kamhdtmyy	pkglfeuw
vagkpx	hltfqqfc
tlumxvkm	ftznztli
mobbnjpiqfzv	jqqvkduh
jniiajelrvzi	wbxfqgxx
sivjfhoardjeot	gxxtrstb
wywmeull	otizzqnz
rknhdvgbqx	vlamhzlv
fgtvcbvbrkca	dopkrkru
qqmrewsprzwa	sscupfnz
ofxfpqqiltbd	hshdmxxl
xgnbacgn	epdlmjcc
lnumsdgchuzgfu	dlienmkb
bgdnr	gpstfohz
nbbjahoxkcfqp	tcsmdbrq
xhlqmzzormpuv	qbmplqwd
pfadkb	vcvukgly
kmbzcwwux	kjlafoiw
kagnv	jirvretz
iaqmyoiwbr	hbyxlwtx
cktltlikpdl	glnyxmpf
qyttyqhxmet	oppbkclw
ohaaua	zirhshhl
iekfqoagdrjptu	lnispkpr
xjvqqcd	tmhftxuu
zlophkau	vvlfkctj
ozetdz	fkfzkbvr
gitps	wjnrwvdz
mmfosyrsfdz	epcbhekp
zjulznhuqik	evrspplh
ridgkfprpgroql	zpajlqrx
oppegandryh	akmpddwu
ohtfhesz	xpwmglsp
hsffbfsp	wvuuqoix
phnhgkzewf	rqwfypmf
txkptemlsuk	bmrotazu
xcwqy	doppviit
zoylbrgls	ufjpfkkl
mjzkmp	adnkliel
cwzvekqarbq	ylakwmvw
knana	kbiqogtk
qrsgrjhhiuju	rxrpwbew
hjspziysufll	ztfjbotx
pqvghti	mqbtzvky
ktxqelrxqc	aevaemqa
ytdmle	fmzrlecg
ukmljcomjlmn	yeprcluq
avjbnwfrcglov	wzzmliyz
wenpi	yjzxlwim
gtckznaw	mzwynewo
uusjfsuerfc	ztohmsro
tkuviuk	nryrltlx
erexzizuy	ghraxztj
ospahi	zawumtss
yplgoghxp	yxmzsxwj
ljwuixqell	wfxwujfl
migmhunzrj	kjuufqee
jrthwtgrelevz	odnvzawq
hzfdhy	jngsfccb
iuztywuozh	jyjiqups
uzzdmiytkavh	irgdscxg
gsdpatjrlklm	kqbsoueo
lyjtbdxa	jagbfvba
uorfadybx	mybdpoba
fdefngmq	ljunqobj
couflif	olvepvlu
rzoxngkx	axprzand
jkbrqrdnvsiio	jznzwbgg
gfrxgtmjjvwmn	odsbamji
vhnufqans	jsjizcvk
qgzfucxvejhmle	vzaardnk
gvwharr	nkynrurp
yabkmfgnhgg	kwsycovj
ocfacusxmjr	klswzzeo
nvtjnrndoyt	dazddtxc
gttunqtowi	wjfpssjf
xfrcg	qilmfnto
nixfdlblhlszf	lknjhsak
tsjfzyyng	nxdsbqwo
jhbquld	dsyfeyyw
dyiclrrlw	mmnicptl
jfbnitloa	loyvswew
